---------------------------------
|                               |
|   #   #   #   #   #   #   #   |
|                               |
|   #   #   #   #   #   #   #   |
|                               |
|   #   #   #   #   #   #   #   |
|                               |
|   #   #   #   #   #   #   #   |
|                               |
|   #   #   #   #   #   #   #   |
|                               |
|   #   #   #   #   #   #   #   |
|                               |
|   #   #   #   #   #   #   #   |
|                               |
---------------------------------